XXXXXXXXXXXXXXXXXXXXXXXXXXXXXXXXXXXXXXXXXXXXXXXXXXXXXXXXXXXXXXXXXXXXXXXXXXXXXXXXXXXXXXXXXXXXXXXXXXXXXXXXXXXXXXXXXXXXXXXXXXX
XWWWWWWWWWWWWWWWWWWWWWWWWWWWWWWWWWWWWWWWWWWWWWWWWWWWWWWWWWWWWWWWWWWWWWWWWWWWWWWWWWWWWWWWWWWWWWWWWWWWWWWWWWWWWWWWWWWWWWWWWWX
XWWWWWWWWWWWWWWWWWWWWWWWWWWWWWWWWWWWWWWWWWWWWWWWWWWWWWWWWWWWWWWWWWWWWWWWWWWWWWWWWWWWWWWWWWWWWWWWWWWWWWWWWWWWWWWWWWWWWWWWWWX
XWWWWWWWWWWWWWWWWWWWWWWWWWWWWWWWWWWWWWWWWWWWWWWWWWWWWWWWWWWWWWWWWWWWWWWWWWWWWWWWWWWWWWWWWWWWWWWWWWWWWWWWWWWWWWWWWWWWWWWWWWX
XWWWWWWWWWWWWWWWWWWWWWWWWWWWWWWWWWWWWWWWWWWWWWWWWWWWWWWWWWWWWWWWWWWWWWWWWWWWWWWWWWWWWWWWWWWWWWWWWWWWWWWWWWWWWWWWWWWWWWWWWWX
XWWWWWWWWWWWWWWWWWWWWWWWWWWWWWWWWWWWWWWWWWWWWWWWWWWWWWWWWWWWWWWWWWWWWWWWWWWWWWWWWWWWWWWWWWWWWWWWWWWWWWWWWWWWWWWWWWWWWWWWWWX
XWWWWWWWWWWWWWWWWWWWWWWWWWWWWWWWWWWWWWWWWWWWWWWWWWWWWWWWWWWWWWWWWPPPWWWWWWWWWWWWWWWWWWWWWWWWWWWWWWWWWWWWWWWWWWWWWWWWWWWWWWX
XWWWWWWWWWWWWWWWWWWWWWWWWWWWWWWWWWWWWWWWWWWWWWWWWWWWWWWWWWPPPPPPPPPPPPPPPWWWWWWWWWWWWWWWWWWWWWWWWWWWWWWWWWWWWWWWWWWWWWWWWWX
XWWWWWWWWWWWWWWWWWWWWWWWWWWWWWWWWWWWWWWWWWWWWWWWWWWPPPPPPPPGGGGGGGGGGGGGPPPWWWWWWWWWWWWWWWWWWWWWWWWWWWWWWWWWWWWWWWWWWWWWWWX
XWWWWWWWWWWWWWWWWWWWWWWWWWWWWWWWWWWPPPPPPPPPPPPPPPPPGGGGGGGGGGGGGGGGGGGGGGPPPPWWWWWWWWWWWWWWWWWWWWWWWWWWWWWWWWWWWWWWWWWWWWX
XWWWWWWWWWWWWWWWWWWWWWWWWWWWWPPPPPPPGGGGGGGGGGGGGGGGGGGGGGGGGGGGGGGGGGGGGGGGPPPPPWWWWWWWWWWWWWWWWWWWWWWWWWWWWWWWWWWWWWWWWWX
XWWWWWWWWWWWWWWWWWWPPPPPPPPPPPGGGGGGGGGGGGGGGGGGGGGGGDDDGGGGGGGGGGGGGGGGGGGGGGGGPPPPPPWWWWWWWWWWWWWWWWWWWWWWWWWWWWWWWWWWWWX
XWWWWWWWWWWWWWWWPPPPGGGGGGGGGGGGGGGGGGGGGGGGGGGGGDDDDDDDDDDGGGGGGGGGGGGGGGGGGGGGGGGGGPPPWWWWWWWWWWWWWWWWWWWWWWWWWWWWWWWWWWX
XWWWWWWWWWWWWWWPPPGGGGGGGGGGGGGGGGGGGGGDDDDDDDDDDDTTTTTTTTDDDDDDGGGGGGGGGGGGGGGGGGGGGPPWWWWWWWWWWWWWWWWWWWWWWWWWWWWWWWWWWWX
XWWWWWWWWWWWWWWWPPPGGGGGGGGGGGGGGGGGDDDDDDDDDDDDDDTDDDDDDTDDDDDDDDDGGGGGGGGGGGGGGGGGPPWWWWWWWWWWWWWWWWWWWWWWWWWWWWWWWWWWWWX
XWWWWWWWWWWWWWWWWWPPPPPGGGGGGGGGGGGGGGDDDDDDDDDDDDTDDDDDDTDDGGGGGGGGGGGGGGGGGGGGGGPPPWWWWWWWWWWWWWWWWWWWWWWWWWWWWWWWWWWWWWX
XWWWWWWWWWWWWWWWWWWWWWPPPGGGGGGGGGGGGGGGGGGDDDDDDDTTTDDTTTGGGGGGGGGGGGGGGGGGGGPPPPPWWWWWWWWWWWWWWWWWWWWWWWWWWWWWWWWWWWWWWWX
XWWWWWWWWWWWWWWWWWWWWWWWPPPPPPPGGGGGGGGGGGGGGGDDDDDGGGGGGGGGGGGGGGGGGGGGGPPPPPPWWWWWWWWWWWWWWWWWWWWWWWWWWWWWWWWWWWWWWWWWWWX
XWWWWWWWWWWWWWWWWWWWWWWWWWWWWWPPPPPPGGGGGGGGGGGGGGGGGGGGGGGGGGGGGGGGGPPPPPWWWWWWWWWWWWWWWWWWWWWWWWWWWWWWWWWWWWWWWWWWWWWWWWX
XWWWWWWWWWWWWWWWWWWWWWWWWWWWWWWWWWWPPPPPPGGGGGGGGGGGGGGGGGGGPPPPPPPPPPWWWWWWWWWWWWWWWWWWWWWWWWWWWWWWWWWWWWWWWWWWWWWWWWWWWWX
XWWWWWWWWWWWWWWWWWWWWWWWWWWWWWWWWWWWWWWWPPPPPPPPGGGGGGPPPPPPPWWWWWWWWWWWWWWWWWWWWWWWWWWWWWWWWWWWWWWWWWWWWWWWWWWWWWWWWWWWWWX
XWWWWWWWWWWWWWWWWWWWWWWWWWWWWWWWWWWWWWWWWWWWWWWPPPPPPPPWWWWWWWWWWWWWWWWWWWWWWWWWWWWWWWWWWWWWWWWWWWWWWWWWWWWWWWWWWWWWWWWWWWX
XWWWWWWWWWWWWWWWWWWWWWWWWWWWWWWWWWWWWWWWWWWWWWWWWWWWWWWWWWWWWWWWWWWWWWWWWWWWWWWWWWWWWWWWWWWWWWWWWWWWWWWWWWWWWWWWWWWWWWWWWWX
XWWWWWWWWWWWWWWWWWWWWWWWWWWWWWWWWWWWWWWWWWWWWWWWWWWWWWWWWWWWWWWWWWWWWWWWWWWWWWWWWWWWWWWWWWWWWWWWWWWWWWWWWWWWWWWWWWWWWWWWWWX
XWWWWWWWWWWWWWWWWWWWWWWWWWWWWWWWWWWWWWWWWWWWWWWWWWWWWWWWWWWWWWWWWWWWWWWWWWWWWWWWWWWWWWWWWWWWWWWWWWWWWWWWWWWWWWWWWWWWWWWWWWX
XWWWWWWWWWWWWWWWWWWWWWWWWWWWWWWWWWWWWWWWWWWWWWWWWWWWWWWWWWWWWWWWWWWWWWWWWWWWWWWWWWWWWWWWWWWWWWWWWWWWWWWWWWWWWWWWWWWWWWWWWWX
XWWWWWWWWWWWWWWWWWWWWWWWWWWWWWWWWWWWWWWWWWWWWWWWWWWWWWWWWWWWWWWWWWWWWWWWWWWWWWWWWWWWWWWWWWWWWWWWWWWWWWWWWWWWWWWWWWWWWWWWWWX
XXXXXXXXXXXXXXXXXXXXXXXXXXXXXXXXXXXXXXXXXXXXXXXXXXXXXXXXXXXXXXXXXXXXXXXXXXXXXXXXXXXXXXXXXXXXXXXXXXXXXXXXXXXXXXXXXXXXXXXXXXX
